WWWWWWWWWWW
WWWWDDDWWWW
WWPPPPPPPWW
WWFFFFFFFWW
WWFFFFFFFWW
WWFFFFFFFWW
WWFFFMFFFWW
WDFFFFFFFWW
WDFFFFFFFWW
WWFFFMFFFWW
WWFFFFFFFWW
WWFFFFFFFWW
WWFFFFFFFWW
WWFFFFFFFWW
WWWWDDDWWWW
WWWWWWWWWWW